10 20 8 6 6 4
..#.##.....#....#.#.
....#.#.#..#..###.##
....#..###.........#
...#.#.#.......##...
.#.......#.##......#
#.....##...#.#..#...
.#.#D...#...#...#..#
....#......##..#..#.
..#..#S..##.##..#...
##.....#..##.......#
