10 20 9 9 2 6
............#.......
....#..#..#.........
.#..##D.#...##.....#
#####...#.#.#.......
#.....#....###..#..#
.#.#.##..#..##..#...
...................#
....###....#....#..#
..........#..#......
...##....S.....#..##
